


             
NO	./assets/WoodDark.png

SO	 ./assets/Copper.png

WE	  ./assets/Caillou.png

EA	 ./assets/Tile.png

F 255,100,0

C 225,30,0

                  111
111111111111111111101
100000000000001000S11
10000001110000100001
10111001110000100001
10111000000000100001
10000000001100011101
10000000001100000001
11111111111111111111
